000000000000000000000000000000000000000000000000000000000000000000000000000000000000000000000000000000000000000000000000
000000000000000000000000000000000000000000000000000000000000000000000000000000000000000000000000000000000000000000000000
000000000000000000000000000000000000000000000000000000000000000000000000000000000000000000000000000000000000000000000000
000002222222222222222200000000000000000000000000000000000000000000000000000000000000000000000000000000000000000000000000
000000011111111111111000000000000000000000000000000000000000000000000000000000000000000000000000000000000000000000000000
000000001110001111100000000022222200000000000000000000000000000000000000000000000000000000000000000000000000000000000000
222222200010001111000000000211111120000002222000000000000000000000000000000000000000000000000000000000000000000000000000
111111100000000010000000000011111100000000110000000222222000000000000000000000000000000000000000000000000000000000000000
011100000000000000000000000000111000000000000000002111110000000000000000000000000000000000000000000000000000000000000000
001000000000000000000000000000010000000000000000000001110000000000000000000000000000000000000000000000000000000000000000
000000000000000000000000000000000000000000000000000001000000000000000000000000000000000000000000000000000000000000000000
000000000000000000000000000000000000000000000000000000000000000000000000000000000000000000000000000000000000000000000000
000000000000000000000000000000000000000000000000000000000000000000000000000000000000000000000000000000000000000000000000
000000000000000000000000000000000000000000000000000000000000000000000000000000000000000000000000000000000000000000000000
000000000000000000000000000000000000000000000000000000000000000000000000000000000000000000000000000000000000000000000000
000000000000000000000000000000000000000000000000000000000000000000000000000000000000000000000000000000000000000000000000
000000000000000000000000000000000000000000000000000000000000000000000000000000000000000000000000000000000000000000000000
000000000000000000000000000000000000000000000000000000000000000000000000000000000000000000000000000000000000000000000000
000000000000000000000000000000000000000000000000000000000000000000000000000000000000000000000000000000000000000000000000
000000000000000000000000000000000000000000000000000000000000000000000000000000000000000000000000000000000000000000000000
000000000000000000000000000000000000000000000000000000000000000000000000000000000000000000000000000000000000000000000000
000000000000000000000000000000000000000000000000000000000000000000000000000000000000000000000000000000000000000000000000
000000000000000000000000000000000000000000000000000000000000000000000000000000000000000000000000000000000000000000000000
000000000000000000000000000000000000000000000000000000000000000000000000000000000000000000000000000000000000000000000000
000000000000000000000000000000000000000000000000000000000000000000000000000000000000000000000000000000000000000000000000
222220000000000000000000000000000000000000000000000000000000000000000000000000000000000000000000000000000000000000000000
111112000000000000000000000222222200002222222220000011110000002200000000000000000000000000000000000000000000000000000000
111000220000000000000000000000111000011100000022000001000000000000000000000000000000000000000000000000000000000000000000
110000000000000000000000000000010000001100000010000000000000022222222000200022222220000000000000000000000000000000000000
100000000000000000000000000000002222220000000100000000000200000000000000000000000000000000000000000000000000000000000000
000000000000000000000000000001111111100000000000002220000000000000000000000000000000000000000000000000000000000000000000
000000000000000000000000000000000000000000000220000000000000000000000000000000000000000000000000000000000000000000000000
000000000000000000000000000000000000000000002000000000000000000000000000000000000000000000000000000000000000000000000000
000000000000000000222222222220000222222222220000000000000000000000000000000000000000000000000000000000000000000000000000
000000022222000000001111111000000000111111000000000000000000000000000000000000000000000000000000000000000000000000000000
000000001110000000000111100000000000011111000000000000000000000000000000000000000000000000000000000000000000000000000000
000000000111000000000001000000000000011000000000000000000000000000000000000000000000000000000000000000000000000000000000
000000000001100000000000000000000000001000000000000000000000000000000000000000000000000000000000000000000000000000000000
000000000000000000000000000000000000000000000000000000000000000000000000000000000000000000000000000000000000000000000000
000000000000000000000000000000000000000000000000000000000000000000000000000000000000000000000000000000000000000000000000
000000000000000000000000000000000000000000000000000000000000000000000000000000000000000000000000000000000000000000000000
000000000000000000000000000000000000000000000000000000000000000000000000000000000000000000000000000000000000000000000000